NO ./textures/space/blue_nebula.xpm
SO ./textures/space/green_nebula.xpm
WE ./textures/space/purple_nebula.xpm
EA ./textures/space/starfield.xpm

F 35, 90, 35
C 120, 170, 220

        111111111111111111111111111111111111111
      111000000000000000000000000000000000000111
    111000111111111111111111111111111111100000111
  111000011000000000000000000000000000001110000111
 1100000110111111111111111111111111111010110000011
11000001101000000000000000000000000000101100000011
110000011010111111111111111111111111101011000000011
1100000110101000000000000000000000000010110000000011
11000001101010111111111111111111111110101100000000011
110000011010101000000000000000000000001011000000000011
110000011010101011111111111111111111101011000000000011
110000011010101010000000000000000000001011000000000011
110000011010101010111111111111111111101011000000000011
110000011010101010100000000000000000001011000000000011
110000011010101010101111111111111111101011000000000011
110000011010101010101000000000000000001011000000000011
110000011010101010101011111111111111101011000000000011
110000011010101010101010000000000000001011000000000011
110000011010101010101010111111111111101011000000000011
110000011010101010101010100000000000001011000000000011
110000011010101010101010101111111111101011000000000011
110000011010101010101010101000000000001011000000000011
11000001101010101010101010100W000000001011000000000011
110000011010101010101010101000000000001011000000000011
110000011010101010101010101111111111101011000000000011
110000011010101010101010100000000000001011000000000011
110000011010101010101010111111111111101011000000000011
110000011010101010101010000000000000001011000000000011
110000011010101010101011111111111111101011000000000011
110000011010101010101000000000000000001011000000000011
110000011010101010101111111111111111101011000000000011
110000011010101010100000000000000000001011000000000011
110000011010101010111111111111111111101011000000000011
110000011010101010000000000000000000001011000000000011
110000011010101011111111111111111111101011000000000011
110000011010101000000000000000000000001011000000000011
11000001101010111111111111111111111110101100000000011
1100000110101000000000000000000000000010110000000011
110000011010111111111111111111111111101011000000011
11000001101000000000000000000000000000101100000011
1100000110111111111111111111111111111010110000011
111000011000000000000000000000000000001110000111
111000111111111111111111111111111111100000111
111000000000000000000000000000000000000111
111111111111111111111111111111111111111