NO ./textures/abstract_green/green_N.xpm
SO ./textures/abstract_green/green_S.xpm
WE ./textures/abstract_green/green_W.xpm
EA ./textures/abstract_green/green_E.xpm

F 74, 87, 89
C 0, 0, 0



               111111111111111111111
           111110000000000000000011111
        111100000000011111100000000001111
      111000000000111111111100000000000111
    111000000001111000000111110000000000111
   1100000000111100000000001111000000000011
  11000000011110001111111000111100000000011
 1100000011110001110000111100011110000000011
 1000000111100011100000000111000111100000001
110000011100011100011111000111000111000000011
1000001110001110001110011100011100011110000001
1000001110001110001100000110001100001110000001
1000001110001110000000N00110001100001110000001
1000001110001110001100000110001100001110000001
1000001110001110001110011100011100011110000001
110000011100011100011111000111000111000000011
 1000000111100011100000000001000111100000001
 1100000011110001110000111100011110000000011
  11000000011110001111111000111100000000011
   1100000000111100000000001111000000000011
    111000000001111000000111110000000000111
      11100000000011110111100000000000111
        111100000000010111100000000001111
           111110000000000000000011111
               111111111111111111111