NO ./textures/abstract_pink/pink_N.xpm
SO ./textures/abstract_pink/pink_S.xpm
WE ./textures/abstract_pink/pink_W.xpm
EA ./textures/abstract_pink/pink_E.xpm

F 120, 120, 140
C 15, 15, 25

 1111111111111111111111111111111111111
1000000000000000000000000000000000001
1100000000000000000000000000000000001
  1000000000000000000000000000000000011
1100000000000000000000000000000000001
100000N000000000000000000000000000001
 1000000000000000000000000000000000001
1000000000000000000000000000000000001
1000000000000000000000000000000000001
1000000000000000000000000000000000001
1000000000000000000000000000000000001
 1000000000000000000000000000000000001
1000000000000000000000000000000000001
1000000000000000000000000000000000001
1111111111111111111111111111111111111
