NO ./textures/abstract_pink/pink_N.xpm
SO ./textures/abstract_pink/pink_S.xpm
WE ./textures/abstract_pink/pink_W.xpm
EA ./textures/abstract_pink/pink_E.xpm

F 120, 120, 140
C 15, 15, 25

1111111111111111111111111111111111111
1000000000000000000000000000000000001
1011111111111111111111111111111111101111111
1111111110100000000000000000000000000000001
1000000000101111111111111111111111111110101
1001111111101000000000000000000000000010101
1001000000001011111111111111111111111010101
1001011111111010000000000000000000010010101
1001010000000010111111111111111111010010101
1001010111111110100000000000000001010010101
1001010100000000101111111111111101010010101
1001010101111111101000000000000101010010101
1001010101000000001011111111110101010010101
1001010101011111111010000000010101010010101
1001010101010000000010111111010101010010101
1001010101010111111110100001010101010010101
100101010101010000000010E000001010101001001
1001010101010111111110100001010101010010101
1001010101010000000010111111010101010010101
1001010101011111111010000000010101010010101
1001010101000000001011111111110101010010101
1001010101111111101000000000000101010010101
1001010100000000101111111111111101010010101
1001010111111110100000000000000001010010101
1001010000000010111111111111111111010010101
1001011111111010000000000000000000010010101
1001000000001011111111111111111111111010101
1001111111101000000000000000000000000010101
1000000000101111111111111111111111111110101
1111111110100000000000000000000000000000001
1011111111111111111111111111111111101111111
1000000000000000000000000000000000001
1111111111111111111111111111111111111