   NO ./textures/abstract_red/red_N.xpm
SO ./textures/abstract_red/red_S.xpm
  WE ./textures/abstract_red/red_W.xpm
EA ./textures/abstract_red/red_E.xpm

F 90, 90, 95
C 10, 10, 12

11111111111111111111111111111111111111111111111111
10000000000000000000000000000000000000000000000001
10111111111111111111111111111111111111111111111101
10100000000000000000000000000000000000000000000101
10101111111111111111111111111111111111111111110101
10101000000000000000000000000000000000000000010101
10101011111111111111111111111111111111111111010101
10101010000000000000000000000000000000000001010101
10101010111111111111111111111111111111111001010101
10101010100000000000000000000000000000001001010101
10101010101111111111111111111111111111101001010101
10101010101000000000000000000000000000101001010101
10101010101011111111111111111111111110101001010101
10101010101010000000000000000000000100101001010101
10101010101010111111111111111111110100101001010101
10101010101010100000000000000000010100101001010101
10101010101010101111111111111111010100101001010101
10101010101010101000000000000001010100101001010101
10101010101010101011111111111101010100101001010101
10101010101010101010000000000101010100101001010101
10101010101010101010111111110101010100101001010101
10101010101010101010100000000101010100101001010101
10101010101010101010100E00000101010100101001010101
10101010101010101010100000000101010100101001010101
10101010101010101010111111110101010100101001010101
10101010101010101010000000000101010100101001010101
10101010101010101011111111111101010100101001010101
10101010101010101000000000000001010100101001010101
10101010101010101111111111111111010100101001010101
10101010101010100000000000000000010100101001010101
10101010101010111111111111111111110100101001010101
10101010101010000000000000000000000100101001010101
10101010101011111111111111111111111110101001010101
10101010101000000000000000000000000000101001010101
10101010101111111111111111111111111111101001010101
10101010100000000000000000000000000000001001010101
10101010111111111111111111111111111111111001010101
10101010000000000000000000000000000000000001010101
10101011111111111111111111111111111111111111010101
10101000000000000000000000000000000000000000010101
10101111111111111111111111111111111111111111110101
10100000000000000000000000000000000000000000000101
10111111111111111111111111111111111111111111111101
10000000000000000000000000000000000000000000000001
11111111111111111111111111111111111111111111111111