SO ./textures/tiles/tile_S.xpm    
NO ./textures/tiles/tile_N.xpm    



F       255,   0,  0           


C       0     ,   0,  255




EA ./textures/tiles/tile_E.xpm


WE     ./textures/tiles/tile_W.xpm





1111111
 1S00001
1000101
 1000011
1111111
