 
NO    ./textures/colorstone.xpm
SO ./textures/greystone.xpm
    C       0,   0,  255
	F 220,100,0
   EA ./textures/redbrick.xpm
   WE     ./textures/wood.xpm
 

11111111111111111111111111111111111111111111111
10000000000000000000000000000000000000000000001
10000000000000001000000000000W00000000000001111
10000000000000001000000000000000000000000001
10000000000000001000000000000000000000000001
10000000000000001000000000000000000000000001
11111111111111111111111111111111111111111111111