NO ./textures/colorstone.xpm
SO ./textures/greystone.xpm
WE ./textures/wood.xpm
EA ./textures/redbrick.xpm

F 220,100,0

C 225,30,0

11111111111
100E0000001
10000000001
1000000W001
10000000001
11111111111
