 

SO ./textures/35.xpm
    C       0,   0,  255
	    F       0,   0,  255
   EA ./textures/redbrick.xpm
   WE     ./textures/wood.xpm
 
    1111111111
   11000000001
1110000001111
100100000011111
1001000010000001111
11100010000010001
10000000000000001
11111111111101111
10000000000000001
10000000000000001
10000000000000001
10000000000000001
10000000000000001