SO ./qualcosa.xpm
NO    ./ciccio.xpm



F       255,   0,  0


    C       0,   0,  255




   EA ciao


   WE     ./texture_occidentale.xpm



11111  11111
100E1  10001
10001  1000
11111  11111