SO ./qualcosa.xpm
NO    ./ciccio.xpm
   EA ciao.xpm


   WE     ./texture_occidentale



F       255,   0,  0


    C       0,   0,  255


11111
100E1
10000
11111




