NO    ./textures/colorstone.xpm

SO 			./textures/greystone.xpm


F       255,   255, 255


    C       0,   0,  0     




   EA ./textures/redbrick.xpm

   WE     ./textures/wood.xpm
   WE     ./textures/wood.xpm

   111111111      1
   1000000001    101
111W01001111      1 
100100000011111     
1001000010000001111
11100010000010001
10000000000000001                    111111111
1111111111110111111111111111111111   1000000001
10000000000000001100000000000000011   1000000001
100000001110000000010000000000000001   11111111111
100000001 1000000010000000000000001              
10000000111000000001000000000000000111111111111111
10000000000000000000000000000000000000000000001
10000000000000001000000000000000000000000000001
1000000000000001000000000000000000000000000001
11111111111111111111111111111111111111111111111
11111111111111111111111111111111111111111111111
10000000000000000000000000000000000000000000001
10000000000000001000000000000000000000000000001
10000000000000001000000000000000000000000000001
11111111111111111111111111111111111111111111111