NO ./textures/35.xpm
SO ./textures/39.xpm
WE ./textures/44.xpm
EA ./textures/45.xpm

F 0,0,0

C 255,255,255

11111111111
10000000001
100N0000001
10000000001
1000000W001
10000000001
11111111111
