  SO ./textures/bricks_multicolor.xpm
  NO ./textures/bricks_multicolor.xpm



F       255,   0,  0


    C       0,   0,  255




   EA ./textures/bricks_multicolor.xpm


   WE     ./textures/bricks_multicolor.xpm





1111111
1000r01
1000001
1000001
1111111