NO ./textures/abstract_green/green_N.xpm
SO ./textures/abstract_green/green_S.xpm
WE ./textures/abstract_green/green_W.xpm
EA ./textures/abstract_green/green_E.xpm



F       255,   0,  0


    C       0,   0,  255








1111111
1000001
100W001
 1000001
1111111